╔══════════════════════════════════════════════════════════════════════════════════════════════════╗
║                                                                                                  ║
║                                                                                                  ║
║                                                                                                  ║
║                                                                                                  ║
║                                                                                                  ║
║                                                                                                  ║
║                                                                                                  ║
║                                                                                                  ║
║                            ╔════════════════════════════════════════╗                            ║
║                            ║                                        ║                            ║
║                            ║                                        ║                            ║
║                            ║                                        ║                            ║
║                            ║                                        ║                            ║
║                            ║                                        ║                            ║
║                            ║                                        ║                            ║
║                            ║                                        ║                            ║
║                            ║                                        ║                            ║
║                            ║                                        ║                            ║
║                                                                                                  ║
║                            ║                                        ║                            ║
║                            ║                                        ║                            ║
║                            ║                                        ║                            ║
║                            ║                                        ║                            ║
║                            ║                                        ║                            ║
║                            ║                                        ║                            ║
║                            ║                                        ║                            ║
║                            ║                                        ║                            ║
║                            ║                                        ║                            ║
║                            ╚════════════════════════════════════════╝                            ║
║                                                                                                  ║
║                                                                                                  ║
║                                                                                                  ║
║                                                                                                  ║
║                                                                                                  ║
║                                                                                                  ║
║                                                                                                  ║
║                                                                                                  ║
╚══════════════════════════════════════════════════════════════════════════════════════════════════╝