╔════════════════════════════╦═════════════════════════════════════════════════════════════════════╗
║                            ║                                                                     ║
║                            ║                                                                     ║
║                            ║                                                                     ║
║                            ║                                                                     ║
║                            ║                                                                     ║
║                            ║                                                                     ║
║                            ║                                                                     ║
║                            ║                                                                     ║
║                            ║                                                                     ║
║                            ║                                                                     ║
║                            ║                                                                     ║
║                            ║                                                                     ║
║                            ║                                                                     ║
║                            ║                                       ║                             ║
║                            ║                                       ║                             ║
║                            ║                                       ║                             ║
║                            ║                                       ║                             ║
║                            ║                                       ║                             ║
║                            ║                                       ║                             ║
║                            ║                                       ║                             ║
║                            ║                                       ║                             ║
║                            ║                                       ║                             ║
║                            ║                                       ║                             ║
║                            ║                                       ║                             ║
║                                                                    ║                             ║
║                                                                    ║                             ║
║                                                                    ║                             ║
║                                                                    ║                             ║
║                                                                    ║                             ║
║                                                                    ║                             ║
║                                                                    ║                             ║
║                                                                    ║                             ║
║                                                                    ║                             ║
║                                                                    ║                             ║
║                                                                    ║                             ║
║                                                                    ║                             ║
║                                                                    ║                             ║
╚════════════════════════════════════════════════════════════════════╩═════════════════════════════╝