╔════════════════════════════╦═════════════════════════════════════════════════════════════════════╗
║                                                                                                 ║
║                                                                                                 ║
║                                                                                                 ║
║                                                                                                 ║
║                    ═════════════════════════                                                     ║
║                   ║
║                   ║                                                                              ║
║                   ║                                                                              ║
║                   ║                                                                              ║
║                   ║                                                                              ║
║                   ║                                                                              ║
║                   ║                                                                              ║
║                   ║                                                                              ║
║                   ║                                                ║                             ║
║                   ║                                                ║                             ║
║                   ║                                                ║                             ║
║                                                                   ║                             ║
║                                                                   ║                             ║
║                                                                   ║                             ║
║                                                                   ║                             ║
║                                                                   ║                             ║
║                                                                   ║                             ║
║                                                                   ║                             ║
║                                                                   ║                             ║
║                                                                    ║                             ║
║                                                                    ║                             ║
║                                                                    ║                             ║
║                                                                    ║                             ║
║                                                                    ║                             ║
║                                                                    ║                             ║
║                                                                    ║                             ║
║                                                                    ║                             ║
║                                                                    ║                             ║
║                                                                    ║                             ║
║                                                                    ║                             ║
║                                                                    ║                             ║
║                                                                    ║                             ║
╚════════════════════════════════════════════════════════════════════╩═════════════════════════════╝